ᥐᥭ ᥑᥢᥳ ᥘᥫᥒ ᥕᥒ ᥑᥬᥲ ᥐᥣᥱ	那么遥远不想去
ᥞᥬᥲ ᥛᥢᥰ ᥙᥣᥰ ᥐᥣᥱ ᥑᥢᥳ ᥘᥫᥒ	让他带去那么多
ᥘᥣᥭᥰ ᥛᥬᥰ ᥙᥥᥢ ᥛᥢᥰ ᥟᥝ ᥐᥣᥱ ᥑᥢᥳ ᥞᥝᥱ 	你的书大概是他拿去了吧
ᥓᥬ ᥑᥢᥳ ᥞᥝᥱ	可能是吧
ᥙᥥᥢ ᥑᥩᥒᥴ ᥛᥬᥰ ᥐᥩᥲ ᥑᥢᥳ ᥞᥝᥱ ᥞᥬᥲ ᥛᥢᥰ ᥖᥪᥰ ᥐᥛᥰ ᥘᥫᥒ ᥖᥤᥴ ᥙᥥᥢ ᥔᥒᥴ	即便是你的，让他用一会儿又有什么关系
ᥑᥩᥒᥴ ᥚᥬᥴ ᥐᥩᥲ ᥑᥢᥳ ᥞᥝᥱ ᥓᥬᥲ ᥛᥢᥰ ᥕᥒ ᥕᥧᥱ ᥖᥤᥴ ᥐᥣᥱ ᥟᥝ ᥞᥥᥖᥱ ᥔᥒᥴ	不管是谁的，主人不在去拿干什么
ᥛᥢᥰ ᥕᥒ ᥛᥣᥰ ᥐᥩᥲ ᥑᥢᥳ ᥞᥝᥳ ᥞᥣᥒᥰ ᥞᥝᥰ ᥟᥥᥢᥲ	他不来就算了，咱们玩儿
ᥕᥒ ᥑᥣᥴ ᥓᥨᥝᥲ ᥐᥩᥲ ᥑᥢᥳ ᥞᥝᥳ ᥑᥪᥢᥰ ᥛᥣᥰ ᥞᥥᥴ	找不着也罢了，回来吧
ᥛᥬᥰ ᥐᥩᥲ ᥑᥢᥳ ᥞᥝᥳ ᥐᥩᥭᥰ ᥞᥣᥒᥰ ᥛᥢᥰ ᥗᥤᥴ ᥞᥪᥴ ᥛᥦᥐᥱ ᥘᥭᥲ ᥙᥥᥳ ᥛᥣᥰ	你也是，就他一个人怎么扛得动呢
ᥐᥣᥱ ᥑᥢᥴ ᥛᥣᥰ ᥑᥢᥴ	快去快来
ᥞᥥᥖᥱ ᥑᥢᥴ ᥓᥦᥢᥴ ᥘᥫᥒ	快点儿做
ᥛᥢᥰ ᥕᥒ ᥙᥣ ᥛᥣᥰ ᥑᥢᥴ	他还没有来呢
ᥐᥝ ᥕᥒᥰ ᥖᥦᥛᥲ ᥘᥣᥭᥰ ᥞᥭᥳ ᥑᥢᥴ	我还正在写着字呢
ᥖᥣᥲ ᥐᥝ ᥘᥭᥲ ᥕᥧᥱ ᥘᥣᥭ ᥑᥢᥴ ᥐᥝ ᥓᥒᥱ ᥖᥦᥛᥴ ᥛᥬᥰ ᥞᥥᥖᥱ ᥞᥬᥲ	等有空的时候我再帮你做
ᥐᥣ ᥛᥢᥰ ᥑᥢᥴ ᥑᥫ ᥞᥣᥲ ᥙᥣᥐᥱ	价钱大约五百
ᥑᥢᥴ ᥑᥫ ᥔᥣᥝᥰ ᥑᥢᥰ ᥘᥫᥒ ᥞᥥᥖᥱ ᥘᥭᥲ ᥛᥦᥢᥳ ᥕᥝᥳ	大约二十天能够做完
ᥕᥒ ᥐᥣᥱ ᥐᥩᥲ ᥑᥢᥴ ᥑᥢᥳ 	不去拉倒
ᥕᥒ ᥑᥬᥲ ᥗᥦᥛᥴ ᥞᥬᥲ ᥐᥩᥲ ᥑᥢᥴ ᥑᥢᥳ ᥙᥭᥱ ᥐᥣᥱ ᥖᥣᥢᥲ ᥕᥝᥳ	不愿帮助就算了，别去讲了
ᥞᥬᥲ ᥛᥬᥰ ᥐᥣᥱ ᥑᥢᥴ ᥑᥢᥴ 	叫你马上去
ᥘᥣᥲ ᥑᥩᥒᥴ ᥘᥣᥒᥴ ᥘᥭᥳ ᥛᥫ ᥘᥭᥳ ᥔᥧᥲ ᥞᥥᥖᥱ ᥑᥢᥴ ᥑᥢᥴ	这件工作今天必须立即做
ᥔᥩᥒᥴ ᥝᥢᥰ ᥘᥭᥳ ᥑᥛᥴ ᥑᥧᥢᥴ ᥙᥨᥝᥰ ᥔᥤᥴ ᥑᥢᥴ ᥐᥣᥖᥱ	这几天，官价贱于市价
ᥛᥣᥒ ᥙᥤ ᥛᥣᥒ ᥕᥣᥛᥰ ᥑᥢᥴ ᥖᥦᥐ ᥑᥝᥲ ᥙᥫᥐᥱ ᥖᥒᥰ ᥘᥨᥢᥰ ᥐᥧᥭ ᥙᥥᥢ ᥔᥣᥛᥴ ᥖᥦᥐ ᥘᥫᥒ	有的年份，粮棉比价是三比一
ᥐᥧᥢᥱ ᥑᥨᥝᥰ ᥛᥣᥒ ᥛᥥᥝᥰ ᥕᥣᥛᥰ ᥛᥭᥲ ᥖᥒᥰ ᥕᥣᥛᥰ ᥐᥖᥴ ᥑᥢᥴ ᥙᥫᥒ ᥐᥢ ᥘᥛᥴ ᥖᥥᥳ	有些商品，夏天与冬天的差价比较大
ᥑᥣᥢᥰ ᥛᥢᥰ ᥗᥪᥒᥴ ᥛᥣᥰ ᥕᥝᥳ	期限到了
ᥛᥢᥰ ᥜᥫᥐᥱ ᥞᥥᥢᥰ ᥑᥣᥢᥰ ᥘᥬ	他在哪个年级学习
ᥑᥨᥒᥳ ᥚᥫᥐᥱ ᥑᥣᥢᥰ ᥔᥧᥒᥴ	高等学校；高校
ᥑᥣᥢᥰ ᥗᥣᥛᥰ ᥛᥢᥰ ᥞᥣᥲ ᥙᥤ	他的任期是五年
ᥕᥧᥱ ᥘᥬᥰ ᥑᥣᥢᥰ ᥙᥣᥐᥱ ᥙᥤ ᥘᥭᥳ ᥞᥝᥰ ᥖᥤᥴ ᥞᥥᥖᥱ ᥘᥣᥲ ᥐᥣᥢ ᥘᥨᥒᥴ ᥔᥤᥙᥴ ᥙᥫᥒ	在本世纪内，咱们要做十件大事
ᥑᥣᥢᥱ ᥑᥦᥖ ᥜᥭᥰ	划火柴
ᥟᥝ ᥙᥤᥲ ᥑᥣᥢᥱ ᥘᥣᥙᥰ ᥞᥥᥴ ᥔᥩᥛᥴ ᥖᥫ ᥝᥭᥳ ᥞᥬᥚ ᥛᥢᥰ ᥛᥣᥰ ᥖᥨᥭᥰ	用笔画几个字留给他回来看
ᥟᥝ ᥘᥤᥐ ᥗᥦᥝᥴ ᥘᥭᥳ ᥑᥣᥢᥱ ᥙᥦᥖ ᥕᥒ ᥟᥝ ᥞᥝᥳ	把这行字画掉不要了
ᥘᥣᥢᥴ ᥑᥣᥢᥱ ᥓᥨᥝᥲ ᥛᥪᥰ	手被刺勾挂了一下
ᥒᥣᥛᥴ ᥞᥥᥖᥱ ᥘᥤ ᥙᥭᥱ ᥞᥬᥲ ᥓᥤᥐᥴ ᥛᥢᥰ ᥑᥣᥢᥱ ᥓᥨᥝᥰ ᥛᥧᥒᥰ ᥞᥫᥢᥰ	小心点儿抬，别让顶端勾挂着天花板
ᥓᥤᥐᥴ ᥑᥣᥢᥱ ᥜᥣᥳ	顶端直刺青天
ᥞᥥᥖᥱ ᥟᥩᥐᥱ ᥘᥩᥒ ᥖᥣᥒᥰ ᥛᥥᥝᥰ ᥘᥭᥳ ᥛᥣᥰ ᥑᥣᥢᥳ ᥖᥣ ᥖᥨ ᥭᥰ ᥖᥥᥳ	做出这种事情来，真讨厌
ᥑᥣᥛᥰ ᥑᥨᥝᥲ ᥘᥭᥳ ᥑᥣᥢᥳ ᥖᥨᥝ ᥙᥥᥢ ᥛᥢᥰ ᥖᥣᥢᥲ	这句话还不是他说的
ᥕᥪᥰ ᥓᥨᥝᥲ ᥞᥨᥝᥴ ᥞᥭᥳ ᥕᥒ ᥘᥭᥲ ᥑᥣᥢᥴ ᥐᥛᥰ ᥔᥤᥴ ᥑᥨᥝᥲ ᥖᥣᥭ ᥐᥛᥰ ᥘᥥᥝ ᥕᥝᥲ	击中头部，未及吭声就已毙命
ᥞᥩᥒᥲ ᥞᥫᥢᥰ ᥑᥣᥢᥴ ᥓᥬ ᥖᥥᥳ 	家境十分贫寒
ᥘᥩᥒ ᥖᥣᥒᥰ ᥑᥣᥢᥴ ᥓᥬ ᥖᥥᥳ	事情很恼火
ᥛᥢᥰ ᥙᥨᥝᥰ ᥑᥣᥢᥴ ᥖᥙ ᥕᥝᥳ	他已经回绝了
ᥛᥢᥰ ᥙᥭ ᥖᥣᥒᥰ ᥑᥤᥢᥴ ᥖᥥᥳ	他走路扭捏作态
ᥑᥥᥢᥰ ᥞᥬᥲ ᥞᥣᥲ ᥝᥢᥰ ᥞᥥᥖᥱ ᥟᥩᥐᥱ ᥛᥣᥰ	限五天做出来
ᥛᥫ ᥘᥬ ᥙᥩᥐ ᥐᥣᥱ ᥐᥩᥲ ᥘᥭᥲ ᥕᥒ ᥑᥥᥢᥰ ᥕᥣᥛᥰ	什么时间回去都可以，不限期限
ᥑᥢᥴ ᥛᥢᥰ ᥑᥥᥢᥰ ᥘᥫᥴ ᥞᥣᥲ ᥙᥣᥐᥱ ᥑᥥᥢᥰ ᥖᥬᥲ ᥔᥣᥛᥴ ᥙᥣᥐᥱ	其价格上限五百，下限三百
ᥓᥨᥝ ᥐᥩᥢᥱ ᥐᥣᥙ ᥓᥛ ᥑᥥᥢᥰ ᥘᥫᥴ ᥖᥥᥰ ᥖᥤ 1840 ᥙᥤ ᥕᥣᥢ ᥘᥭᥳ ᥑᥥᥢᥰ ᥖᥬᥲ ᥗᥪᥒᥴ 1919 ᥙᥤ ᥕᥣᥛᥰ ᥝᥨᥰ ᥔᥪᥱ ᥕᥤᥢᥱ ᥖᥨᥒᥱ ᥕᥣᥢ ᥘᥭᥳ	近代史上限至一八零四年左右，下限至一九一九年“五四”运动时期
ᥚᥣᥳ ᥛᥦᥢ ᥘᥭᥳ ᥑᥥᥢᥲ ᥐᥣᥱ ᥞᥦᥒᥰ ᥖᥥᥳ ᥕᥝᥳ	这把刀勚了许多
ᥔᥨᥢᥲ ᥐᥦᥙᥱ ᥖᥤᥢ ᥑᥥᥢᥲ ᥐᥣᥱ ᥟᥤᥖᥴ ᥘᥫᥒ	鞋后跟磨损了一点儿
ᥖᥨᥐᥱ ᥛᥣᥐᥱ ᥞᥥᥙᥱ ᥞᥥᥴ ᥞᥣᥱ ᥘᥫᥒ ᥚᥖ ᥞᥩ ᥛᥬ ᥛᥭᥳ ᥙᥨᥝᥰ ᥑᥥᥲ ᥐᥣᥱ ᥛᥦᥢᥳ	下了一场雹子，树叶被打得光秃秃的
ᥛᥭᥳ ᥕᥫᥒᥰ ᥘᥢᥳ ᥜᥫᥴ ᥛᥢᥰ ᥑᥥᥢᥲ ᥓᥧᥛᥱ ᥑᥧᥛ ᥞᥨᥒᥴ	那蓬竹子叶子光秃秃的
ᥖᥨᥝ ᥘᥣᥭᥰ ᥓᥫᥰ ᥑᥩᥐᥴ ᥘᥫᥴ ᥛᥢᥰ ᥘᥢᥳ ᥙᥨᥝᥰ ᥑᥥᥢᥲ ᥞᥣᥭᥴ ᥐᥣᥱ ᥛᥦᥢᥲ ᥕᥝᥳ	刻写在上面的文字都已经销蚀了
ᥖᥣᥒᥰ ᥙᥥᥢ ᥛᥢᥰ ᥔᥩᥒᥴ ᥝᥢᥰ ᥘᥭᥳ ᥑᥦᥢᥰ ᥛᥣᥰ ᥑᥩᥒ ᥘᥫᥒ ᥕᥝᥳ	他的病情近日有所好转
ᥙᥭᥱ ᥞᥬᥲ ᥞᥥᥖᥱ ᥛᥢᥰ ᥑᥦᥢᥰ ᥞᥥᥖᥱ	叫他别做他偏要做
ᥝᥣ ᥐᥣ ᥑᥧᥢᥴ ᥛᥫᥒᥰ ᥕᥣᥢᥴ ᥞᥫᥭᥰ ᥑᥦᥢᥰ ᥖᥨᥝ ᥖᥨᥒᥰ ᥐᥣᥛᥰ ᥑᥨᥝᥲ ᥞᥥᥝᥰ ᥔᥣᥢᥴ ᥛᥩᥐᥱ	来自远方的客官啊，且听奴家细开言
ᥘᥝᥲ ᥖᥝᥲ ᥘᥭᥳ ᥑᥦᥢᥱ ᥖᥥᥳ 	这瓶酒酽得很
ᥐᥩᥒᥰ ᥐᥩᥒᥰ ᥘᥝᥲ ᥞᥨᥝᥴ ᥞᥩᥒᥰ ᥟᥣᥭ ᥑᥦᥢᥱ	好酒味醇
ᥕᥣᥲ ᥓᥫᥰ ᥘᥭᥳ ᥕᥒ ᥑᥦᥢᥱ ᥑᥬ 	这种烟不辣
ᥟᥣᥭ ᥕᥥᥝ ᥑᥦᥢᥱ ᥞᥦᥒᥰ ᥖᥥᥳ	尿臊味儿浓烈
ᥑᥦᥢᥱ ᥑᥝᥲ ᥞᥬᥲ ᥙᥤ ᥘᥩᥒᥳ	给客人挜饭
ᥑᥦᥢᥱ ᥘᥝᥲ ᥞᥬᥲ ᥖᥭᥰ ᥐᥨᥝᥳ	给朋友劝酒
ᥛᥢᥰ ᥓᥣᥒ ᥑᥦᥢᥳ 	他会武术
ᥔᥩᥒᥴ ᥝᥢᥰ ᥘᥭᥳ ᥕᥒ ᥘᥭᥲ ᥑᥦᥢᥳ	这几天没有空闲时间
ᥗᥨᥒᥴ ᥙᥣᥰ ᥑᥦᥢᥴ ᥙᥣᥭ ᥚᥣᥴ ᥞᥭᥳ	筒巴挂在篱笆上
ᥙᥭᥱ ᥑᥦᥢᥴ ᥔᥧᥒᥴ ᥚᥦᥝᥴ	别挂得太高
ᥛᥥ ᥐᥭᥱ ᥑᥦᥢᥴ ᥟᥥᥴ	母鸡护雏
ᥘᥩᥒ ᥖᥣᥒᥰ ᥑᥝᥴ ᥕᥒᥰ ᥖᥫᥐ ᥑᥦᥢᥴ ᥑᥣᥱ ᥝᥭᥳ ᥑᥢᥴ 	他们的事情还悬而未决
ᥙᥭᥱ ᥝᥣ ᥘᥩᥒ ᥖᥣᥒᥰ ᥕᥒ ᥘᥐᥴ ᥘᥣᥴ ᥓᥬᥱ ᥟᥝ ᥛᥢᥰ ᥑᥦᥢᥴ ᥖᥦᥝᥱ ᥖᥤ ᥔᥧᥒᥴ	别认为事情不重要就把它束之高阁
ᥛᥢᥰ ᥐᥤᥢ ᥑᥧᥢ ᥕᥒ ᥐᥤᥢ ᥐᥛ	他吃荤不吃斋
ᥛᥢᥰ ᥐᥣᥱ ᥑᥨᥢ ᥑᥨᥢᥴ ᥖᥣᥒᥰ ᥞᥭᥳ	他迷了路
ᥑᥤᥱ ᥐᥣᥰ ᥖᥒᥰ ᥝᥧᥰ ᥚᥦᥝᥴ ᥞᥧᥝᥴ ᥑᥧᥢ	整天坐汽车头晕
ᥙᥥᥢ ᥘᥐᥴ ᥚᥦᥝᥴ ᥑᥧᥢ ᥐᥣᥱ	病情严重，昏迷不醒
ᥔᥪᥳ ᥘᥭᥲ ᥚᥐᥴ ᥐᥣᥖᥱ ᥛᥣᥰ ᥞᥣᥲ ᥑᥧᥢᥰ	买到了五捆青菜
ᥜᥣᥳ ᥓᥒᥱ ᥘᥦᥒᥰ ᥑᥧᥢᥱ ᥑᥧᥢᥱ	天刚蒙蒙亮
ᥜᥣᥳ ᥑᥧᥢᥱ ᥔᥝᥲ ᥛᥩᥐᥱ ᥘᥣᥒ ᥒᥛᥰ ᥓᥣᥱ ᥛᥫᥒᥰ ᥛᥩᥒᥴ 	天空模模糊糊，云雾迷迷茫茫笼罩在大地上
ᥙᥥᥖᥱ ᥕᥣᥳ ᥞᥨᥝᥴ ᥘᥛᥳ ᥞᥭᥳ ᥘᥛᥳ ᥑᥧᥢᥱ ᥔᥧᥐᥴ ᥛᥧᥭᥴ ᥞᥨᥒᥴ	鸭子在水源寻食，把水搅得浑浊不清
ᥛᥣᥳ ᥛᥧᥢᥱ ᥔᥦᥢᥴ ᥑᥧᥢᥱ ᥝᥐ	万马奔腾
ᥖᥨᥝ ᥘᥣᥭᥰ ᥑᥥᥱ ᥖᥫ ᥘᥭᥳ ᥛᥤᥰ ᥔᥣᥛᥴ ᥑᥧᥢᥳ	这个汉字有三横儿
ᥘᥣᥭᥰ ᥖᥨᥝ ᥘᥭᥳ ᥑᥧᥢᥳ ᥛᥢᥰ ᥕᥒ ᥘᥛᥴ	这个字的笔画不多
ᥐᥨᥢᥰ ᥐᥨᥝᥳ ᥘᥢᥳ ᥑᥧᥢᥳ ᥖᥥᥳ	那个人真蛮横
ᥘᥣᥭᥰ ᥑᥥᥱ ᥖᥨᥝ ᥘᥭᥳ ᥑᥧᥢᥳ ᥙᥤᥲ ᥛᥢᥰ ᥘᥛᥴ ᥖᥥᥳ	这个汉字笔画很多
ᥔᥩᥒᥴ ᥑᥧᥢᥴ ᥔᥣᥛᥴ ᥘᥣᥒᥰ ᥙᥭ ᥜᥦᥒᥴ ᥑᥣᥒᥰ ᥕᥣᥒ ᥞᥣᥒᥱ	两男三女同偕行，迈开大步如流星
ᥑᥧᥢᥴ ᥝᥣᥢᥱ ᥚᥩᥒᥰ ᥛᥫᥒᥰ	宰相；丞相
ᥑᥧᥢᥴ ᥞᥩᥒᥴ ᥙᥣᥒᥰ ᥗᥛᥰ	唐僧请经
ᥗᥩᥐᥱ ᥟᥩᥒᥲ ᥚᥬᥴ ᥟᥩᥒᥲ ᥛᥢᥰ ᥙᥭᥱ ᥑᥨᥢᥰ ᥐᥢ 	各倒一处，别混杂在一起
ᥟᥢ ᥘᥤ ᥟᥢ ᥓᥣᥲ ᥑᥨᥢᥰ ᥑᥣᥝᥳ ᥐᥢ ᥝᥭᥳ	好的坏的混在一起
ᥐᥝ ᥛᥤᥰ ᥑᥨᥢᥴ ᥞᥨᥝᥴ ᥞᥩᥐᥱ ᥔᥩᥒᥴ ᥔᥣᥛᥴ ᥔᥥᥢᥲ	我有两三根白头发
